.....	.....	Punct
no	no	Ok
see	see	Ok
inetu	inetu	Ok
lugu	lugu	Ok
korstnapühkija	korstnapühkija	Ok
oli	oli	Ok
ikka	ikka	Ok
küll	küll	Ok
,	,	Punct
et	et	Ok
korstnasse	korstnasse	Ok
panna	panna	Ok
...	...	Punct
aga	aga	Ok
matsid	matsid	Ok
on	on	Ok
matsid	matsid	Ok
nagu	nagu	Ok
vene	vene	Ok
revolutsionärid	revolutsionäärid	Spell_Missing_Diacritics
,	,	Punct
et	et	Ok
kohe	kohe	Ok
köik	kõik	Spell_ED_1
ära	ära	Ok
lõhkuda	lõhkuda	Ok
,	,	Punct
hävitada	hävitada	Ok
...	...	Punct
matsid	matsid	Ok
Nägin	Nägin	Ok
unes	unes	Ok
,	,	Punct
et	et	Ok
Kangro	Kangro	Name
maksis	maksis	Ok
kõik	kõik	Ok
võlad	võlad	Ok
ära	ära	Ok
Täiesti	Täiesti	Ok
nõus	nõus	Ok
Lugejaga	Lugejaga	Name
-	-	Punct
parim	parim	Ok
kaasaegne	kaasaegne	Ok
skulptor	skulptor	Ok
!	!	Punct
juba	juba	Ok
see	see	Ok
Kangro	Kangro	Name
kottimine	kottimine	Ok
.	.	Punct
Kõigil	Kõigil	Ok
on	on	Ok
lastud	lastud	Ok
erastada	erastada	Ok
,	,	Punct
aga	aga	Ok
mees	mees	Ok
maksab	maksab	Ok
ikka	ikka	Ok
renti	renti	Ok
ruumide	ruumide	Ok
eest	eest	Ok
,	,	Punct
mille	mille	Ok
on	on	Ok
ammu	ammu	Ok
juba	juba	Ok
korda	korda	Ok
teinud	teinud	Ok
.	.	Punct
Kaua	Kaua	Ok
linn	linn	Ok
võib	võib	Ok
ühe	ühe	Ok
mehe	mehe	Ok
käest	käest	Ok
raha	raha	Ok
välja	välja	Ok
pumbata	pumbata	Ok
?	?	Punct
Noh	Noh	Ok
,	,	Punct
kui	kui	Ok
oskab	oskab	Ok
linnaisadega	linnaisadega	Ok
äri	äri	Ok
teha	teha	Ok
,	,	Punct
siis	siis	Ok
muidugi	muidugi	Ok
parim	parim	Ok
(	(	Punct
äritegija	äritegija	Ok
)	)	Punct
.	.	Punct
Kui	Kui	Ok
näeks	näeks	Ok
linnaruumis	linnaruumis	Ok
ka	ka	Ok
teiste	teiste	Ok
skuptorite	skuptorite	Ok
taieseid	taieseid	Ok
,	,	Punct
siis	siis	Ok
saaks	saaks	Ok
võrrelda	võrrelda	Ok
.	.	Punct
Praegu	Praegu	Ok
see	see	Ok
võimalus	võimalus	Ok
puudub	puudub	Ok
.	.	Punct
Pall	Pall	Ok
käib	käib	Ok
vaid	vaid	Ok
ühe	ühe	Ok
mehe	mehe	Ok
väravasse	väravasse	Ok
ja	ja	Ok
konkurents	konkurents	Ok
puudub	puudub	Ok
.	.	Punct
Õnneks	õnneks	Ok
pole	pole	Ok
tema	tema	Ok
Kalevipoega	Kalevipoega	Name
veel	veel	Ok
pandud	pandud	Ok
merre	merre	Ok
mune	mune	Ok
leotama	leotama	Ok
....	....	Punct
gunztiasjatundjatelt	gunztiasjatundjatelt	Ok
küsiks	küsiks	Ok
hääl	heal	Spell_ED>1
meelel	meelel	Ok
,	,	Punct
kas	kas	Ok
nad	nad	Ok
sellist	sellist	Ok
võõrast	võõrast	Ok
nime	nime	Ok
nagu	nagu	Ok
Mati	Mati	Name
Karmin	Karmin	Name
on	on	Ok
kuulnud	kuulnud	Ok
?	?	Punct
..	..	Punct
nõus	nõus	Ok
Lugejaga	Lugejaga	Ok
Siin	Siin	Ok
pole	pole	Ok
midagi	midagi	Ok
tegemist	tegemist	Ok
üldsuse	üldsuse	Ok
või	või	Ok
kunstiteadlaste	kunstiteadlaste	Ok
hinnanguga	hinnanguga	Ok
.	.	Punct
Piisab	Piisab	Ok
vaid	vaid	Ok
teatud	teatud	Ok
ametimehele	ametimehele	Ok
meeldimisest	meeldimisest	Ok
-	-	Punct
ning	ning	Ok
igale	igale	Ok
järjekordsele	järjekordsele	Ok
skulptuurile	skulptuurile	Ok
on	on	Ok
linnas	linnas	Ok
koht	koht	Ok
garanteeritud	garanteeritud	Ok
.	.	Punct
Põhjenduski	Põhjenduski	Ok
on	on	Ok
olemas	olemas	Ok
-	-	Punct
turistidele	turistidele	Ok
meeldivat	meeldivat	Ok
nende	nende	Ok
juures	juures	Ok
pildistada	pildistada	Ok
.	.	Punct
Tegelikult	tegelikult	Ok
pildistatakse	pildistatakse	Ok
kõige	kõige	Ok
sagedamini	sagedamini	Ok
ikka	ikka	Ok
eriti	eriti	Ok
veidrate	veidrate	Ok
ja	ja	Ok
grotesksete	grotesksete	Ok
objektide	objektide	Ok
kõrval	kõrval	Ok
,	,	Punct
kuna	kuna	Ok
ilus	ilus	Ok
objekt	objekt	Ok
varjutaks	varjutaks	Ok
pildistatava	pildistatava	Ok
väärtused	väärtused	Ok
.	.	Punct
Niipalju	Niipalju	Ok
Kangro	Kangro	Name
taiestest	taiestest	Ok
.	.	Punct
Võlad	Võlad	Ok
on	on	Ok
muidugi	muidugi	Ok
iseasi	iseasi	Ok
.	.	Punct
Loomulikult	loomulikult	Ok
teeb	teeb	Ok
Kangro	Kangro	Name
linnaga	linnaga	Ok
korruptsiooni	korruptsiooni	Ok
.	.	Punct
Kust	kust	Ok
see	see	Ok
raha	raha	Ok
tuli	tuli	Ok
??	??	Punct
linna	linna	Ok
kassast	kassast	Ok
loomulikult	loomulikult	Ok
.	.	Punct
Hea	Hea	Ok
jah	jah	Ok
et	et	Ok
Kalevipoega	Kalevipoega	Name
pole	pole	Ok
tulnud	tulnud	Ok
!!	!!	Punct
see	see	Ok
on	on	Ok
ju	ju	Ok
täielik	täielik	Ok
jama	jama	Ok
mida	mida	Ok
Kangro	Kangro	Name
teeb	teeb	Ok
.	.	Punct
Järgmine	Järgmine	Ok
K	K	Abbrev
-	-	Punct
kalevipoeg	kalevipoeg	Ok
Tegelikult	tegelikult	Ok
peaks	peaks	Ok
kalevipoeg	kalevipoeg	Ok
ikka	ikka	Ok
lahte	lahte	Ok
üles	üles	Ok
pandama	pandama	Ok
,	,	Punct
siis	siis	Ok
saaksid	saaksid	Ok
turistid	turistid	Ok
paadiga	paadiga	Ok
selle	selle	Ok
kuju	kuju	Ok
kõrval	kõrval	Ok
pildistamas	pildistamas	Ok
käia	käia	Ok
.	.	Punct
Ja	Ja	Ok
paadilaenutusfirma	paadilaenutusfirma	Ok
saaks	saaks	Ok
tööd	tööd	Ok
.	.	Punct
Iseasi	Iseasi	Ok
muidugi	muidugi	Ok
,	,	Punct
kas	kas	Ok
see	see	Ok
seal	seal	Ok
lainetes	lainetes	Ok
ka	ka	Ok
püsib	püsib	Ok
.	.	Punct
Hiidlained	Hiidlained	Ok
ja	ja	Ok
torm	torm	Ok
juba	juba	Ok
kolmapäeval	kolmapäeval	Ok
platsis	platsis	Ok
....	....	Punct
Väide	Väide	Ok
,	,	Punct
et	et	Ok
linnas	linnas	Ok
puuduvad	puuduvad	Ok
teiste	teiste	Ok
kunstnike	kunstnike	Ok
tööd	tööd	Ok
on	on	Ok
räme	räme	Ok
vale	vale	Ok
.	.	Punct
Tallinna	Tallinna	Name
Skulptuurisümpoosionite	Skulptuurisümpoosionite	Ok
ajal	ajal	Ok
2003	2003	Ok
-	-	Punct
2008	2008	Ok
on	on	Ok
linnaruumi	linnaruumi	Ok
paigutatud	paigutatud	Ok
48	48	Ok
erinevate	erinevate	Ok
skulptorite	skulptorite	Ok
taiest	taiest	Ok
.	.	Punct
Millegipärast	Millegipärast	Ok
ka	ka	Ok
need	need	Ok
ei	ei	Ok
meeldi	meeldi	Ok
meie	meie	Ok
lugupeetud	lugupeetud	Ok
"	"	Punct
Gunstigurmaanidele	Gunstigurmaanidele	Ok
"	"	Punct
.	.	Punct
Perverdist	Perverdist	Ok
irisejate	irisejate	Ok
meelest	meelest	Ok
on	on	Ok
tõsised	tõsised	Ok
kunstiprojektid	kunstiprojektid	Ok
igatmasti	igatmasti	Ok
poolepeeretajaist	poolepeeretajaist	Ok
äpude	äpude	Ok
installatsioonid	installatsioonid	Ok
,	,	Punct
mis	mis	Ok
aga	aga	Ok
millegipärast	millegipärast	Ok
laiema	laiema	Ok
publiku	publiku	Ok
poolehoidu	poolehoidu	Ok
ei	ei	Ok
pälvi	pälvi	Ok
.	.	Punct
mis	mis	Ok
mull	mull	Ok
selle	selle	Ok
loo	loo	Ok
löpus	lõpus	Spell_ED_1
nyyd	nüüd	Spell_Missing_Diacritics
siis	siis	Ok
oli	oli	Ok
??	??	Punct
yleeelmise	üleeelmise	Spell_Missing_Diacritics
aasta	aasta	Ok
uudised	uudised	Ok
?	?	Punct
"	"	Punct
Kesklinnavalitsus	Kesklinnavalitsus	Ok
oli	oli	Ok
hoiatanud	hoiatanud	Ok
Kangrot	Kangrot	Name
üürilepingu	üürilepingu	Ok
erakorralise	erakorralise	Ok
ülesütlemise	ülesütlemise	Ok
eest	eest	Ok
.	.	Punct
"	"	Punct
Siin	Siin	Ok
oli	oli	Ok
ju	ju	Ok
lehtedest	lehtedest	Ok
laia	laia	Ok
seakisa	seakisa	Ok
kuulda	kuulda	Ok
kui	kui	Ok
Kangro	Kangro	Name
oma	oma	Ok
eluruumid	eluruumid	Ok
ärastas	ärastas	Ok
-	-	Punct
mis	mis	Ok
jutt	jutt	Ok
see	see	Ok
üürilepingust	üürilepingust	Ok
siin	siin	Ok
veel	veel	Ok
on	on	Ok
?	?	Punct
